20 20
4 2 7 1 8 3 5 2 9 1 4 2 7 1 8 3 5 2 9 1
5 1 6 2 4 8 1 3 7 2 5 1 6 2 4 8 1 3 7 2
3 8 2 5 1 7 4 2 9 1 3 8 2 5 1 7 4 2 9 1
1 4 9 3 2 5 8 1 6 2 1 4 9 3 2 5 8 1 6 2
7 2 5 1 8 4 3 9 2 1 7 2 5 1 8 4 3 9 2 1
2 6 1 4 7 2 5 8 1 3 2 6 1 4 7 2 5 8 1 3
8 1 4 9 2 6 1 3 5 2 8 1 4 9 2 6 1 3 5 2
5 3 8 2 1 9 4 7 2 1 5 3 8 2 1 9 4 7 2 1
1 7 2 5 8 3 6 1 9 2 1 7 2 5 8 3 6 1 9 2
4 2 9 1 5 7 2 8 1 3 4 2 9 1 5 7 2 8 1 3
2 5 1 8 4 2 9 1 6 7 2 5 1 8 4 2 9 1 6 7
9 1 7 3 2 6 5 4 8 1 9 1 7 3 2 6 5 4 8 1
3 8 2 6 1 9 4 7 2 5 3 8 2 6 1 9 4 7 2 5
6 4 1 9 5 2 8 1 3 2 6 4 1 9 5 2 8 1 3 2
1 2 8 4 7 1 5 9 2 6 1 2 8 4 7 1 5 9 2 6
5 9 3 2 6 8 1 4 7 1 5 9 3 2 6 8 1 4 7 1
2 7 5 1 9 3 2 6 8 4 2 7 5 1 9 3 2 6 8 4
8 1 4 7 2 5 9 1 3 2 8 1 4 7 2 5 9 1 3 2
4 5 9 2 1 7 3 8 1 6 4 5 9 2 1 7 3 8 1 6
7 2 6 8 3 1 4 5 9 2 7 2 6 8 3 1 4 5 9 2
