16 16
4 2 8 1 5 9 3 7 2 6 4 8 1 5 9 3
7 3 6 2 4 8 1 5 9 4 7 3 6 2 4 8
1 5 9 3 7 2 6 4 8 1 5 9 3 7 2 6
4 8 1 5 9 3 7 2 6 4 8 1 5 9 3 7
2 6 4 8 1 5 9 3 7 2 6 4 8 1 5 9
9 4 7 3 6 2 4 8 1 5 9 4 7 3 6 2
1 5 9 3 7 2 6 4 8 1 5 9 3 7 2 6
4 8 1 5 9 3 7 2 6 4 8 1 5 9 3 7
2 6 4 8 1 5 9 3 7 2 6 4 8 1 5 9
7 3 6 2 4 8 1 5 9 4 7 3 6 2 4 8
1 5 9 3 7 2 6 4 8 1 5 9 3 7 2 6
4 8 1 5 9 3 7 2 6 4 8 1 5 9 3 7
2 6 4 8 1 5 9 3 7 2 6 4 8 1 5 9
9 4 7 3 6 2 4 8 1 5 9 4 7 3 6 2
1 5 9 3 7 2 6 4 8 1 5 9 3 7 2 6
4 8 1 5 9 3 7 2 6 4 8 1 5 9 3 7
