13 13
1 2 1 2 1 2 1 2 1 2 1 2 1
2 3 4 3 4 3 4 3 4 3 4 3 2
1 4 5 6 5 6 5 6 5 6 5 4 1
2 3 6 7 8 7 8 7 8 7 6 3 2
1 4 5 8 9 9 9 9 9 8 5 4 1
2 3 6 7 9 1 1 1 9 7 6 3 2
1 4 5 8 9 1 2 1 9 8 5 4 1
2 3 6 7 9 1 1 1 9 7 6 3 2
1 4 5 8 9 9 9 9 9 8 5 4 1
2 3 6 7 8 7 8 7 8 7 6 3 2
1 4 5 6 5 6 5 6 5 6 5 4 1
2 3 4 3 4 3 4 3 4 3 4 3 2
1 2 1 2 1 2 1 2 1 2 1 2 1
