15 15
7 2 4 8 1 5 9 3 6 2 4 8 1 5 9
3 6 2 4 8 1 5 9 3 6 2 4 8 1 5
8 1 5 9 3 6 2 4 8 1 5 9 3 6 2
4 8 1 5 9 3 6 2 4 8 1 5 9 3 6
2 4 8 1 5 9 3 6 2 4 8 1 5 9 3
9 3 6 2 4 8 1 5 9 3 6 2 4 8 1
5 9 3 6 2 4 8 1 5 9 3 6 2 4 8
1 5 9 3 6 2 4 8 1 5 9 3 6 2 4
6 2 4 8 1 5 9 3 6 2 4 8 1 5 9
3 6 2 4 8 1 5 9 3 6 2 4 8 1 5
8 1 5 9 3 6 2 4 8 1 5 9 3 6 2
4 8 1 5 9 3 6 2 4 8 1 5 9 3 6
2 4 8 1 5 9 3 6 2 4 8 1 5 9 3
9 3 6 2 4 8 1 5 9 3 6 2 4 8 1
5 9 3 6 2 4 8 1 5 9 3 6 2 4 8
