12 12
  66      88      59      39      78       8       6      81      58      75      79      85    
  70      42      39      26      26      82      46      32      29      80      95      90    
  18      23      70       2       8      94      70      99      38      85      66      75    
  82      76      41      61      74      94      79      52      57      36      94      84    
  17      11       7      36      81      79      57      87      29      90      41      62    
  38      88      51      86      23      76      51      93      76      18      88      71    
  79      31      46      61      73      22      64      18      91      42       9      74    
  25      30      88      84      75      86      84       9      89      97      52      25    
  34      80      85      71      52      55      41      82      68      42      41      16    
  49      85      40      55       9       6      50      20       4      50      66      14    
  47      88      29      61      63      57      42      19      92      52      64      14    
  17      39      58      98      15      73      56      92      44      47      56      11
