11 11
4 2 7 1 8 3 5 9 2 6 4
8 1 5 9 3 7 2 6 4 1 8
2 9 4 6 1 8 7 3 5 2 9
7 3 8 2 6 4 9 1 3 8 5
1 6 2 8 4 9 3 5 7 4 2
9 5 3 7 2 1 8 4 6 9 3
3 8 9 4 5 2 1 7 8 5 6
6 4 1 5 9 7 2 8 3 1 7
5 7 6 3 8 1 4 2 9 6 4
2 1 5 8 7 6 9 3 4 2 1
8 9 2 1 3 5 6 4 1 7 8
